111111111
100000001
100000001
10E00C001
100000001
1P0000001
100E00001
100000001
111111111