111111111
100000001
100000001
1P000C001
100000001
100000001
100000001
10P0000E1
111111111