111111111
100000001
100000001
10000C001
100000001
1P00000011
100000001
1000000E1
111111111