1111111111111111111111111
1010010010000000000000101
1E00000000000000000000001
1010010000000000000010101
100000000000000000000C001
1010010010000000000000101
101P010010000000000000101
1111111111111111111111111
