111111111111111111111
100000011010000011000100C01001
111110111111011001011101100101
1C0000011101011011000000000101
111011010000011111110111011101
101011011110110001000001011101
1000100000110101110111C1100101
111110111000000101011100001101
100000101110111100000101100001
111101100000P00001110111111101
100000111011011101000100010101
111110111111010001011111010101
10C000011110001100011000000101
110110101111101101111011011101
100010100000100001100001000101
101010111011111101101101C10101
101000001010000100000001010101
101111011010111110111101010101
1000000C0000100000010101010101
111010111101101101110101010101
1C1010000000000000000100000101
101110101011011101011111101101
100000C0100000001100010000E001
111111111111111111111111111111
