111111111
100000001
100000001
10000C001
100000001
1P0000001
100000001
100000001
111111111